############
#...........
#...........
#...........
#...@.......
#...........
#...........
############