############
#......#....
#....#.#....
#....#.#....
#...@#.#####
#....#......
#....#......
############