############
#....#......
#...#..#####
#..@#..#....
#...#..#..#.
#....#2212.#
#..........#
############