############
#.....1#....
#....#.#....
#....#.#....
#...@#.#####
#....#......
#....#......
############