############
..#...#....#
@.#........#
..#...##...#
..#.#......#
.#..#......#
...#......*#
############