#############
............#
@...........#
............#
............#
............#
............#
#############