#############
..#...#....#
@.#........#
..#...##...#
..#.#......#
.#..#......#
...#......*#
#############