############
#....#.*...#
#......##..#
@.#..12#..##
#...#..#...#
#....#2212.#
#......#...#
############