############
#....#.*...#
#....22##..#
@.#..12#..##
#...#..#...#
#....#2212.#
#......#...#
############